1111111
1000001
100CP01
1000001
1111111
