11111111
10000001
10P0E001
10011101
1000C001
11111111
