1111111
0000001
10PCE01
1000001
1111111
