1111111111
1000000001
10CC000001
10P0E00001
1000000001
1111111111
