11111111
10P0E001
10000001
10111101
1001C101
11111111
