11111111
10000001
10P0C001
10011101
10000E01
11111111
