1111111
1000001
100PE01
1000001
1111111
