111111111
100000001
1CCCCC0E1
10P000001
1CCCCC001
100000001
111111111
