1111111111111111111111111111111111
1000000000000000000000000000000001
1000C00000000000000000000000000001
1000000000000000000000000000000001
1000000000000000000000000000000001
1000000000000000000000000000000001
1000000000000000000000000000C00001
1000000000000000000000000000000001
1000P00000000000000000000000000001
1000000000000000000000000000000001
1000000000000000000000000000000001
1000000000000000000000000000000001
1000000000000000000000000000000E01
1111111111111111111111111111111111
