1111111
1P00001
100CE01
10P0001
1111111
