1111111
1E00001
100CP01
10E0001
1111111
