11111111
10P0C001
10000001
10111101
1001E101
11111111
