1111111
1000001
10PCEX1
1000001
1111111
