1111111
1000001
100CE01
1000001
1111111
