1111111
1000000
10PCE01
1000001
1111111
