111111111111111111111
1P0001000000100000001
10100101110101111C101
10101001000101000C101
1010100111010111C0101
10101C000001C0000C101
101010111111111110101
1C101000000000000C001
101011111111111111011
1010000000000000000C1
10111111111111111C101
10100000000000000C101
101C111111111111110C1
10001000000000100C001
1111101111111110111C1
1000101000C00010100E1
101010101110101010111
101010100000101010001
1C1010111110101011101
10101000000C1010C0001
10101111111110111C1C1
1C000000000000C000001
111111111111111111111