11111111111
1P00000E001
11111111111
1C00000C001
11111111111