11111111111
1P0C0C0C001
10111111111
1000000000E
11111111111