111111111
100E00001
1P0000E01
111111111