11111111111111111111111111111111111111111111111111
1E000000000000000000000000000000000000000000000001
10111111111111111111111111111111111111111111111101
1C10000000000000000000000000000000000000000000C001
10101111111111111111111111111111111111111111110101
10100000000000000C00000000000C000000000000000010101
10111111111111111111111111111111111111111111110101
10000000000000000000000000000000000000000000000101
11111111111111111111111111111111111111111111110101
1C0000000000000000000000000000C00000000000000C0101
10111111111111111111111111111111111111111111110101
10100000000000000000000000000000000000000000010101
10101111111111111111111111111111111111111111010101
10100000C00000000000000000000000000000000000010101
10111111111111111111111111111111111111111111110101
10000000000000000000000P000000000000000000000C0101
10111111111111111111111111111111111111111111110101
10100000000000000000000000000000000000000000010101
10101111111111111111111111111111111111111111010101
10100000000000000000000000000000000000000000010101
10111111111111111111111111111111111111111111110101
1C000000000000000000000000000000000000000000000101
11111111111111111111111111111111111111111111110101
10000000000000000000000000000000000000000C00000C01
10111111111111111111111111111111111111111111111101
10000000000000000000000000000000000000000000000001
11111111111111111111111111111111111111111111111111