1111111111111111111
1E00000000C00000001
10110111011101101C1
10100000C00001C0101
1010111111111010101
100000C000000000101
111101C111110111101
1C0001000000010C001
1011111111111111011
100000C00P00000C001
1111111111111111111