1111111111111111111111111111
1P00C00N0000C00N0000C00N000E1
10111111111111111111111111101
10C00N000C00N000C00N000C00N01
10111111111111111111111111101
10N000C00N000C00N000C00N000C1
10111111111111111111111111101
10C00N000C00N000C00N000C00N01
10111111111111111111111111101
10N000C00N000C00N000C00N000C1
10111111111111111111111111101
10C00N000C00N000C00N000C00N01
10111111111111111111111111101
10000000000000000000000000001
1111111111111111111111111111
