1111111111111111
1P00000000000001
100C0C0C0C000001
10000N0000000001
100C0C0C0C000001
10000N0000000001
100C0C0C0C000001
1000000000000E01
1111111111111111
