11111111111111111111
1P0000000000000000E1
10C000N00N00N000C01
1000111111111110001
10C0100000000010C01
1000100N000N00100001
10C0100000000010C01
1000111111111110001
10C000N00N00N000C01
10000000000000000001
11111111111111111111
